X	X	X	-	-	-	-	-	-	-	-	-	-	X	X
X	X	X	-	N	N	N	-	-	N	N	N	-	X	X
X	X	X	-	N	N	N	-	-	N	N	N	-	X	X
X	X	X	-	N	N	N	-	-	N	N	N	-	X	X
X	X	X	-	N	N	N	N	N	N	N	N	-	X	X
X	X	X	-	-	-	-	-	-	-	-	N	-	X	X
X	X	X	X	X	X	X	X	X	X	-	N	-	X	X
-	-	-	-	-	-	-	-	X	X	-	N	-	X	X
N	N	N	N	N	N	N	-	-	-	-	N	-	-	-
N	N	-	N	N	N	N	N	N	N	N	N	N	N	N
N	N	-	-	-	N	N	-	-	-	-	N	-	-	-
N	N	-	X	-	N	N	-	X	X	-	N	-	X	X
N	-	-	X	-	-	-	-	X	X	-	N	-	-	-
N	-	X	X	X	X	X	X	X	X	-	N	N	N	N
P	-	X	X	X	X	X	X	X	X	-	N	N	N	N